0 3 0 4 0 0 0 7 9
0 4 0 0 0 0 3 0 0
6 7 1 0 8 0 2 0 0
0 5 6 1 0 0 0 0 7
0 9 0 0 4 3 5 1 0
0 2 0 0 0 0 8 3 6
4 0 5 0 0 0 0 9 3
7 6 3 5 0 4 0 2 8
9 0 0 7 3 1 4 0 5
