0 0 0 2 0 0 0 0 0
6 9 5 0 0 8 2 4 3
0 0 2 5 6 0 1 0 0
5 0 6 0 0 2 0 0 1
0 0 9 4 8 5 6 0 2
0 8 0 6 1 0 4 5 0
0 0 0 9 0 3 8 0 4
3 2 0 0 4 6 9 0 5
0 0 4 8 0 1 0 2 0
