4 0 0 1 0 5 7 6 0
0 3 5 6 2 7 4 0 1
1 6 0 8 0 4 2 0 0
0 0 9 0 0 0 8 0 3
0 0 6 0 8 0 1 4 0
7 8 4 0 1 0 9 0 6
0 4 0 0 0 0 3 9 0
8 9 2 0 0 0 0 7 0
5 7 0 0 4 2 0 0 0
