6 9 0 3 0 4 0 0 0
1 4 7 0 5 0 0 0 0
0 3 0 0 7 9 0 0 0
0 0 4 0 0 6 8 0 0
7 0 9 1 0 5 0 6 3
2 5 6 0 0 0 0 7 1
5 0 1 9 8 7 0 0 2
9 0 0 0 0 0 7 0 8
4 0 8 5 3 2 1 9 0
