0 0 0 1 0 0 8 0 9
3 0 0 0 0 4 1 0 7
0 1 9 0 7 0 0 0 0
0 0 5 3 2 1 9 0 8
9 3 0 4 0 8 0 1 2
0 8 0 0 6 0 0 0 5
6 0 1 5 4 7 0 8 0
2 0 0 0 1 3 5 9 4
5 0 3 0 0 0 0 6 1
