0 8 4 0 0 0 5 9 0
6 0 0 0 0 0 0 0 1
1 0 5 0 0 0 3 0 2
0 0 0 5 0 4 0 0 0
0 0 0 0 7 0 0 0 0
0 0 0 6 0 8 0 0 0
5 0 2 0 0 0 4 0 6
3 0 0 0 0 0 0 0 5
0 9 7 0 0 0 2 8 0
