0 0 4 8 0 0 0 0 0
0 0 2 1 0 0 0 0 0
0 0 8 9 0 0 7 3 2
0 0 0 0 0 0 8 7 6
0 0 0 0 0 0 0 0 0
9 5 6 0 0 0 0 0 0
1 2 5 0 0 9 6 0 0
0 0 0 0 0 2 5 0 0
0 0 0 0 0 7 4 0 0
