0 0 0 0 0 4 1 0 0
1 9 4 0 3 0 0 2 0
3 0 0 6 0 0 0 0 7
4 8 7 0 0 0 0 0 0
0 0 0 0 0 0 0 0 0
0 0 0 0 0 0 3 5 6
7 0 0 0 0 1 0 0 3
0 6 0 0 7 0 8 4 2
0 0 8 2 0 0 0 0 0
