0 0 8 7 0 0 0 0 0
0 0 3 2 0 0 9 5 0
6 9 0 0 0 0 7 4 0
8 2 0 0 0 0 0 0 0
0 0 0 0 4 0 0 0 0
0 0 0 0 0 0 0 6 3
0 1 2 0 0 0 0 7 9
0 3 4 0 0 6 5 0 0
0 0 0 0 0 5 2 0 0
