0 9 7 4 0 0 0 0 0
0 4 0 5 0 1 3 7 0
0 0 0 0 0 2 0 8 0
1 0 5 0 0 0 0 0 0
2 3 4 0 0 0 5 6 7
0 0 0 0 0 0 4 0 8
0 5 0 6 0 0 0 0 0
0 2 8 1 0 3 0 9 0
0 0 0 0 0 7 6 2 0
