0 0 0 0 0 7 0 4 0
0 0 2 0 9 5 0 1 7
0 4 6 0 0 0 0 0 0
0 0 0 0 2 9 0 3 4
0 9 0 7 0 8 0 5 0
4 2 0 1 3 0 0 0 0
0 0 0 0 0 0 7 2 0
2 3 0 8 1 0 9 0 0
0 1 0 6 0 0 0 0 0
